1111111
1000001
100P001
1000001
1C00E01
1000001