1111111
100X001
100P001
1000001
1C00E01
1111111