1111111
1P00001
100P001
1000001
1C00E01
1111111