11111111111
1000P001101
1001111E101
10010001111
10010C00001
11111111111