11111111111
1000P0001C1
1001110E001
10010001111
10010C00001
11111111111