11111111111
1000P000101
10011100001
10010001111
10010C00001
11111111111