11111111111
1000P000001
10000000001
10000000001
10000000001
11111111111