1111111
1P0C011
1000E11
1111111