1111111111111111111
100000000000000E001
1000000000000000001
1000000000000000001
1000000000000000001
1000000000000000001
1000000000000000001
1000000000000000001
10000P0000000000001
1000000000000000001
1000000000000000001
1111111111111111111