111111111
100000001
10000P001
111111111
100C00001
100000E01
111111111
