11111111111
1000P00010111
1001110E00101
1001000111111
10010C00001
11111111111