11111111111
1000P000101
1001110E001
10010001111
10010C00000
11111111111